Rd, Hh, Hh, Mm, Mm, Mm, Mm, Mm, Mm, Mm, Mm, Mm, Mm, Mm, Mm, Mm, Mm, Mm, Mm, Mm, Mm, Mm^Xm, Mm^Xm, Mm^Xm, Mm^Xm, Mm^Xm, Mm^Xm, Mm^Xm, Mm^Xm, Mm^Xm, Mm^Xm, Mm^Xm, Mm^Xm, Mm^Xm, Ha, Ms, Ha, Aa^Fpa, Aa^Fpa, Aa^Fpa, Aa^Fpa, Aa^Fpa, Aa^Fpa, Aa^Fpa, Aa^Fpa, Aa^Fpa, Aa, Aa^Fpa, Aa^Fpa, Aa^Fpa, Aa^Fpa, Aa^Fpa
Hh, Rd, Rd, Hh, Mm, Mm, Mm, Mm, Mm, Mm, Mm, Mm, Mm, Mm, Mm, Mm, Mm, Mm, Mm, Mm, Mm, Mm^Xm, Mm^Xm, Mm^Xm, Mm^Xm, Mm^Xm, Mm^Xm, Mm^Xm, Mm^Xm, Mm^Xm, Mm^Xm, Mm^Xm, Mm^Xm, Mm, Ha, Ms, Ha^Vhha, Aa^Fpa, Chr, Aa^Fpa, Aa^Fpa, Aa^Fpa, Aa^Fpa, Gg^Ve, Aa^Fpa, Aa^Fpa, Aa^Fpa, Aa^Fpa, Aa^Fpa, Aa^Fpa, Aa^Fpa, Aa^Fpa
Hh, Hh, Rd, Hh, Hh, Mm, Mm, Mm, Mm, Mm, Mm, Mm, Mm, Mm, Mm, Mm, Mm, Mm, Mm, Mm, Ms, Mm^Xm, Mm^Xm, Mm^Xm, Ms, Mm^Xm, Mm^Xm, Mm^Xm, Mm^Xm, Mm^Xm, Mm, Mm, Mm, Mm, Ha, Ha, Aa^Fpa, Aa^Fpa, Aa^Fpa, Aa^Fpa, Aa^Fpa, Aa^Fpa, Aa^Fpa, Aa^Fpa, Aa^Fpa, Aa^Fpa, Aa^Fpa, Aa^Fpa, Aa^Fpa, Aa^Fpa, Aa^Fpa, Aa^Fpa
Mm, Hh, Rd, Hh, Hh, Mm, Mm, Mm, Mm, Mm, Mm, Mm, Mm, Mm, Mm, Mm, Mm, Mm, Mm, Mm, Mm, Mm, Mm, Mm, Mm, Mm^Xm, Mm^Xm, Mm^Xm, Mm^Xm, Mm, Mm, Mm, Mm, Mm, Mm, Ha, Aa, Aa^Fpa, Aa, Ha, Ha, Aa, Ha, Aa^Fpa, Aa, Aa^Fpa, Ce, Aa^Fpa, Aa, Aa^Fpa, Aa^Fpa, Aa^Fpa
Mm, Hh, Hh, Rd, Rd, Hh, Hh, Mm, Mm, Mm, Mm, Mm, Mm, Mm, Mm, Mm, Mm, Mm, Mm, Mm, Mm^Vhh, Mm, Mm, Mm, Mm, Mm, Mm^Vhh, Mm^Xm, Mm, Mm, Mm, Mm, Mm, Mm, Mm, Hh, Gs^Fp, Gs^Fp, Gs^Fp, Gs^Fp, Hh, Hh, Gs^Fp, Gs^Fp, Gs^Fp, Ce, 2 Ke, Gs^Fp, Gs^Fp, Hh, Gs^Fp, Gs^Fp
Mm, Mm, Hh, Hh, Hh, Rd, Rd, Hh, Hh, Mm, Mm, Mm, Mm, Mm, Mm, Mm, Mm^Vhh, Mm, Mm, Mm, Mm, Mm, Mm, Mm, Mm, Mm, Mm, Mm, Mm, Mm, Mm, Mm, Mm, Mm, Mm^Vhh, Hh, Hh, Gs^Fp, Gs^Fp, Gs^Fp, Hh, Hh, Gs^Fp, Hh^Fp, Gs^Fp, Ce, Ce, Ce, Gs^Fp, Gs^Fp, Gs^Fp, Gs^Fp
Mm, Mm, Mm, Hh, Hh, Hh, Hh, Rd, Rd, Hh, Hh, Hh, Hh, Mm, Mm, Mm, Mm, Mm, Mm, Mm, Mm, Mm, Mm, Mm, Mm, Mm, Mm, Mm, Mm, Mm, Mm, Mm, Mm, Mm, Mm, Hh, Hh, Gs^Fp, Gs^Fp, Gs^Fp, Gs^Fp, Gg^Ve, Gs^Fp, Gs^Fp, Rd, Rd, Gs^Fp, Gs^Fp, Gs^Fp, Gs^Fp, Hh, Gs^Fp
Mm, Mm, Mm, Mm, Mm, Mm, Hh, Hh, Rd, Hh, Hh, Hh, Hh, Hh, Hh, Mm, Mm, Mm, Mm, Mm, Hh, Mm, Mm, Mm, Mm, Mm, Mm, Mm, Mm, Mm, Mm, Mm, Mm, Mm, Mm, Hh, Hh, Gs^Fp, Gg^Efm, Gs^Fp, Gs^Fp, Gs^Fp, Rd, Rd, Gs^Fp, Gs^Fp, Gs^Fp, Gs^Fp, Gs^Fp, Hh, Hh, Gs^Fp
Mm, Mm, Mm, Mm, Mm, Mm, Hh, Hh, Hh, Rd, Rd, Rd, Rd, Hh, Hh, Hh, Hh, Mm, Hh, Hh, Gs^Fp, Hh, Hh, Mm, Hh^Vhh, Mm, Mm, Mm, Hh, Hh, Hh, Mm, Mm, Mm, Mm, Hh^Fp, Gs^Fp, Gs^Fp, Gg^Efm, Gg^Efm, Gg^Efm, Gg^Efm, Gg^Efm, Gs^Fp, Gs^Fp, Gs^Fp, Gs^Fp, Gg^Ve, Gs^Fp, Gs^Fp, Gs^Fp, Gs^Fp
Mm^Xm, Mm, Mm^Xm, Mm, Mm, Mm, Mm, Hh, Hh, Hh, Hh, Hh, Hh, Rd, Rd, Hh, Hh, Hh, Ce, Ce, Ce, Gs^Fp, Gs^Fp, Gs^Fp, Rd, Hh, Rd, Hh, Rd, Hh, Rd, Hh, Hh, Mm, Mm, Hh^Fp, Hh, Gs^Fp, Gg^Efm, Gg^Efm, Gg^Efm, Gg^Efm, Gg^Efm, Gs^Fp, Gs^Fp, Gs^Fp, Gs^Fp, Gs^Fp, Gs^Fp, Gs^Fp, Gs^Fp, Gs^Fp
Mm^Xm, Ms, Mm^Xm, Mm^Xm, Mm, Mm, Mm, Mm, Mm, Hh, Mm^Vhh, Hh, Hh, Hh, Hh, Rd, Rd, Gs^Fp, Ce, 1 Ke, Ce, Ce, Rd, Rd, Rd, Rd, Rd, Rd, Rd, Rd, Rd, Rd, Rd, Hh^Fp, Hh^Fp, Mm, Hh^Vhh, Gs^Fp, Gg^Efm, Gg^Efm, Gg^Efm, Gg^Efm, Gg^Efm, Gg^Efm, Hh^Vhh, Gs^Fp, Gs^Fp, Gg^Efm, Gs^Fp, Gs^Fp, Gs^Fp, Gs^Fp
Mm^Xm, Mm^Xm, Mm^Xm, Mm^Xm, Ms, Mm, Mm, Mm, Mm, Mm, Mm, Mm, Mm, Hh, Hh, Hh, Hh, Rd, Rd, Ce, Rd, Rd, Rd, Rd, Rd, Gs^Fp, Mm, Gs^Fp, Hh, Hh, Gs^Fp, Rd, Rd, Rd, Hh, Hh, Gs^Fp, Gs^Fp, Gg^Efm, Gg^Efm, Gg^Efm, Gg^Efm, Gg^Efm, Gs^Fp, Gs^Fp, Gs^Fp, Gs^Fp, Gs^Fp, Gs^Fp, Gs^Fp, Gs^Fp, Gs^Fp
Mm^Xm, Mm^Xm, Mm^Xm, Mm^Xm, Mm^Xm, Mm^Xm, Mm^Xm, Mm, Mm, Mm, Mm, Mm, Mm, Mm, Mm, Hh, Hh^Vhh, Hh, Rd, Rd, Hh, Hh, Mm, Rd, Rd, Rd, Rd, Mm, Mm^Xm, Mm, Mm, Hh, Hh, Rd, Rd, Gs^Fp, Rd, Rd, Gs^Fp, Gg^Efm, Gg^Efm, Gg^Efm, Gg^Efm, Gs^Fp, Rd, Gg^Efm, Hh, Gs^Fp, Hh^Fp, Gs^Fp, Gs^Fp, Gs^Fp
Mm^Xm, Mm^Xm, Mm^Xm, Mm^Xm, Mm^Xm, Mm^Xm, Mm^Xm, Ms, Mm, Mm, Mm, Mm, Mm, Mm, Hh, Hh, Rd, Gs^Fp, Rd, Rd, Hh, Mm^Vhh, Mm, Mm, Mm^Xm, Rd, Rd, Rd, Hh, Mm, Hh^Fp, Mm^Vhh, Rd, Rd, Rd, Rd, Gs^Fp, Gs^Fp, Gs^Fp, Gg^Efm, Gg^Efm, Gg^Efm, Gs^Fp, Rd, Gs^Fp, Gs^Fp, Hh, Hh, Gs^Fp, Gs^Fp, Gs^Fp, Gs^Fp
Mm^Xm, Mm^Xm, Ms, Mm^Xm, Mm, Mm^Xm, Mm, Mm, Ha, Mm, Mm, Mm, Hh, Mm, Hh, Rd, Rd, Rd, Hh, Rr, Mm, Mm, Mm, Mm^Xm, Mm, Mm^Xm, Rp, Rd, Rp, Hh, Rd, Gs^Fp, Rd, Rd, Hh, Gs^Fp, Gs^Fp, Gs^Fp, Gs^Fp, Gs^Fp, Hh, Gg^Efm, Gs^Fp, Gs^Fp, Gg^Ve, Hh, Hh, Hh, Gs^Fp, Gs^Fp, Gs^Fp, Gs^Fp
Ms, Mm^Xm, Mm, Mm, Mm, Mm, Mm, Mm, Mm^Vhh, Mm, Mm, Hh, Ds, Hh, Rd, Rd, Rd, Hh, Mm, Chr, Khr, Mm, Ms, Mm^Xm, Mm^Xm, Ss, Ss^Bw/, Rp, Hh, Rp, Rd, Rd, Hh, Hh, Mm, Gs^Fp, Hh, Gs^Fp, Gs^Fp, Gs^Fp, Gs^Fp, Gs^Fp, Gs^Fp, Gs^Fp, Gs^Fp, Hh, Hh^Fp, Hh^Fp, Hh, Gs^Fp, Gs^Fp, Gs^Fp
Ms, Ms, Mm, Mm, Mm, Mm, Mm, Mm, Ha, Hh, Gs^Fp, Mm, Rd, Rd, Rd, Rd, Hh, Gs^Fp, Hh, Mm, Chw, Mm, Mm^Xm, Mm^Xm, Cud, Cud, Mm, Mm, Hh, Rp, Hh, Mm, Mm, Mm, Hh, Gg^Vc, Gs^Fp, Gs^Fp, Gs^Fp, Gs^Fp, Re, Gs^Fp, Gs^Fp, Rd, Hh, Hh, Hh^Fp, Hh, Hh, Gs^Fp, Gs^Fp, Gs^Fp
Ms, Ms, Ms, Mm, Mm, Mm, Ha, Mm, Hh, Gs^Fp, Rd, Rd, Rd, Rd, Gs^Fp, Hh, Mm, Mm, Mm, Rp, Ww, Ds, Mm^Xm, Cud, Cud, Cud, Cud, Mm, Hh, Rp, Hh, Mm, Hh, Hh^Vhh, Rp, Rp, Rp, Gs^Fp, Gg^Vc, Gs^Fp, Gs^Fp, Gs^Fp, Hh, Gs^Fp, Gs^Fp, Gs^Fp, Gs^Fp, Gs^Fp, Hh, Gs^Fp, Gs^Fp, Gs^Fp
Ms, Ms^Vhha, Ha, Mm, Mm, Mm, Mm, Chr, Rp, Rd, Rd, Rd, Gs^Fp, Rd, Gs^Fp, Hh^Fp, Hh, Mm, Rp, Mm^Vhh, Ww, Ww, Mm^Xm, 6 Kud, Cud, Cud, Ss, Ss^Bw\, Rp, Rp, Rp, Gs^Fp, Cud, Rp, Re^Gvs, Re^Gvs, Re^Gvs, Rp, Rp, Gs^Fp, Gg^Vc, Gs^Fp, Gs^Fp, Gs^Fp, Gs^Fp, Gs^Fp, Gs^Fp, Gs^Fp, Gs^Fp, Gs^Fp, Gs^Fp, Gs^Fp
Mm, Ms, Mm, Hh, Hh, Chr, Hh, Gs^Fp, Rd, Rd, Gs^Fp, Gs^Fp, Hh, Rd, Rd, Hh, Hh, Hh, Rd, Mm, Mm, Ww, Mm^Xm, Cud, Mm^Xm, Mm^Xm, Hh, Rd, Hh, Mm, Hh^Vhh, Rp, Rp, Rp, Re^Gvs, Re^Gvs, Re^Gvs, Re^Gvs, Gg^Wm, Rp, Rp, Gs^Fp, Gg^Vc, Gs^Fp, Gs^Fp, Re, Gs^Fp, Gs^Fp, Gs^Fp, Gg^Ve, Gs^Fp, Gs^Fp
Mm, Mm, Mm, Mm, Ds, Rp, Gg^Ve, Rd, Rd, Gs^Fp, Hh^Fp, Hh, Hh, Hh, Gs^Fp, Rd, Rd, Gs^Fp, Rd, Mm, Ds, Ww, Mm, Mm^Xm, Mm, Mm^Vhh, Rd, Rd, Mm, Mm, Hh, Cud, Rp, Wwf, Wwf, Re^Gvs, Re^Gvs, Re^Gvs, Re^Gvs, Re^Gvs, Re^Gvs, Rp, Gs^Fp, Gs^Fp, Gs^Fp, Gs^Fp, Gs^Fp, Gs^Fp, Gs^Fp, Gs^Fp, Gs^Fp, Gs^Fp
Mm, Mm, Mm, Mm, Hh, Rp, Rp, Rd, Rd, Hh, Mm, Mm, Mm, Hh, Hh^Fp, Gs^Fp, Gs^Fp, Rd, Rd, Hh, Ds, Ww, Hh, Gs^Fp, Hh, Hh, Rd, Mm, Mm, Hh, Gg^Vc, Rp, Re^Gvs, Re^Gvs, Re^Gvs, Wwf, Wwf, Re^Gvs, Re^Gvs, Re^Gvs, Re^Gvs, Rp, Gg^Vc, Gs^Fp, Rd, Gs^Fp, Gs^Fp, Gs^Fp, Gs^Fp, Gs^Fp, Gs^Fp, Gs^Fp
Mm, Mm, Mm, Mm^Vhh, Hh, Gs^Fp, Rd, Rd, Mm^Vhh, Mm, Mm^Xm, Mm^Xm, Mm^Xm, Mm, Mm, Chr, Rp, Rd, Gs^Fp, Rd, Gs^Fp, Ww, Rd, Rd, Rd, Rd, Gs^Fp, Hh, Hh, Hh, Gs^Fp, Rp, Re^Gvs, Re^Gvs, Re^Gvs, Re^Gvs, Re^Gvs, Wwf, Wwf, Re^Gvs, Rp, Rp, Gs^Fp, Gs^Fp, Gs^Fp, Gs^Fp, Re, Hh^Fp, Hh, Gs^Fp, Gs^Fp, Gs^Fp
Mm, Mm, Mm, Ha, Hh, Gs^Fp, Rd, Rd, Hh, Mm, Mm^Xm, Mm^Xm, Mm^Xm, Mm, Gs^Fp, Rp, Chr, Gs^Fp, Gs^Fp, Rd, Rd, Ww^Bw/, Ww, Hh, Hh, Gs^Fp, Gs^Fp, Gs^Fp, Gs^Fp, Gs^Fp, Gs^Fp, Rp, Rp, Re^Gvs, Gg^Ve, Re^Gvs, Re^Gvs, Re^Gvs, Rp, Rp, Gs^Fp, Gg^Vc, Gs^Fp, Gs^Fp, Gs^Fp, Gs^Fp, Hh^Fp, Hh^Fp, Gs^Fp, Gs^Fp, Gs^Fp, Gs^Fp
Mm, Mm, Mm, Hh, Gs^Fp, Rd, Rd, Rd, Rd, Hh, Rp, Mm^Xm, Rp, Mm, Rd, Rp, Mm, Khr, Chr, Gs^Fp, Hh, Rd, Hh, Ww, Ww, Ss^Vhs, Gs^Fp, Gs^Fp, Gs^Fp, Gs^Fp, Gs^Fp, Gg^Vc, Gs^Fp, Rp, Rp, Re^Gvs, Re^Gvs, Re^Gvs, Rp, Gg^Vc, Cud, Gs^Fp, Gs^Fp, Gs^Fp, Gs^Fp, Rd, Gs^Fp, Gs^Fp, Gg^Ve, Gs^Fp, Gs^Fp, Gs^Fp
Mm, Mm, Mm, Hh, Hh, Rd, Rd, Rd, Hh, Rd, Gs^Fp, Rp, Hh, Rd, Hh, Mm, Hh^Fp, Chr, Gs^Fp, Gs^Fp, Gs^Fp, Rd, Rd, Gs^Fp, Hh, Ww, Ww, Hh, Hh, Gs^Fp, Gs^Fp, Gs^Fp, Rp, Rp, Gg^Vc, Rp, Rp, Rp, Cud, Re, Re, Gs^Fp, Gs^Fp, Gs^Fp, Gs^Fp, Rd, Rd, Gs^Fp, Gs^Fp, Gs^Fp, Chr, Gs^Fp
Mm, Mm, Mm, Ha, Hh, Rd, Rd, Hh, Mm, Mm, Mm, Hh, Gs^Fp, Hh, Mm, Hh, Hh, Gs^Fp, Ds, Ds, Hh, Gs^Fp, Gs^Fp, Rd, Gs^Fp, Gs^Fp, Ww, Gs^Fp, Gs^Fp, Gs^Fp, Rp, Rp, Gs^Fp, Gs^Fp, Gs^Fp, Gs^Fp, Rp, Gg^Vc, Gs^Fp, Gs^Fp, Gs^Fp, Re, Re, Gs^Fp, Gs^Fp, Gs^Fp, Gs^Fp, Gs^Fp, Gs^Fp, Gs^Fp, Gs^Fp, Gs^Fp
Mm, Mm, Mm, Mm, Mm, Rd, Rd, Gs^Fp, Hh, Mm, Mm, Mm, Mm^Xm, Hh^Fp, Mm, Mm, Ww, Gs^Fp, Ww, Wwr, Ww, Mm, Hh, Rd, Rd, Gs^Fp, Gs^Fp, Ww, Ww^Bw/, Rp, Ww, Gs^Fp, Ss, Gs^Fp, Gs^Fp, Gs^Fp, Rp, Gs^Fp, Rd, Gs^Fp, Gs^Fp, Rd, Gs^Fp, Re, Re, Gs^Fp, Rd, Gs^Fp, Gs^Fp, Gs^Fp, Gs^Fp, Gs^Fp
Mm, Mm, Mm, Mm, Mm^Vhh, Rd, Rd, Gs^Fp, Mm, Mm, Mm, Mm^Xm, Mm^Xm, Mm^Xm, Ai, Ai, Ww, Ww, Ww, Ww, Ww, Ds, Mm, Hh, Gs^Fp, Rd, Rp, Rp, Ww^Bw\, Ww, Wwr, Ww, Ww, Ss, Ss, Gs^Fp, Rp, Gs^Fp, Gs^Fp, Gs^Fp, Hh, Re, Hh, Gs^Fp, Rd, Re, Re, Gs^Fp, Gs^Fp, Gs^Fp, Gs^Fp, Gs^Fp
Mm, Mm, Mm, Mm, Hh, Rd, Rd, Gs^Fp, Mm, Mm, Mm^Vhh, Mm^Xm, Mm^Xm, Mm^Xm, Mm, Ds, Mm, Mm, Gs^Fp, Ss^Vhs, Gs^Fp, Ww, Ww, Hh, Gs^Fp, Cud, Rp, Ss^Vhs, Ww, Ww, Ww, Ww, Ww, Ww, Ss, Gs^Fp, Hh, Rp, Hh^Vhh, Gs^Fp, Re, Re, Rd, Gs^Fp, Rd, Gs^Fp, Gs^Fp, Re, Re, Re, Re, Gs^Fp
Mm, Mm, Mm, Ha, Ds, Rd, Rd, Gs^Fp, Hh, Mm, Hh, Mm, Mm, Hh, Mm, Mm, Hh, Hh, Hh^Fp, Gs^Fp, Gs^Fp, Ww, Gs^Fp, Ww, Ww, Gs^Fp, Rp, Ss^Vhs, Ww, Ww, Wo, Wo, Ww, Ww, Ss, Gs^Fp, Hh, Rp, Rp, Gs^Fp, Gs^Fp, Gs^Fp, Gs^Fp, Re, Gs^Fp, Hh, Gs^Fp, Rd, Gs^Fp, Rd, Gs^Fp, Re
Mm, Mm, Hh, Aa^Fpa, Rd, Rd, Rd, Hh, Rd, Hh, Rd, Gs^Fp, Hh, Mm, Gs^Fp, Mm, Mm, Hh, Gs^Fp, Hh, Mm, Hh, Mm, Gs^Fp, Gs^Fp, Ww, Ww^Bw|, Ww, Ww, Ww, Wo, Wo, Ww, Ww, Ss, Gs^Fp, Gs^Fp, Gs^Fp, Rp, Gs^Fp, Gs^Fp, Gs^Fp, Rd, Re, Gs^Fp, Re, Gs^Fp, Rd, Gs^Fp, Rd, Rd, Gs^Fp
Hh, Mm^Vhh, Rd, Rd, Rd, Rd, Rd, Rd, Rd, Rd, Rd, Rd, Rd, Hh, Gs^Fp, Gs^Fp, Hh, Hh, Rd, Rd, Rd, Mm, Mm, Hh, Gg^Efm, Gs^Fp, Rp, Ww, Ww, Ww, Ww, Wo, Wwr, Ww, Gs^Fp, Gs^Fp, Gs^Fp, Gs^Fp, Rp, Gs^Fp, Chs, Chs, Gs^Fp, Rd, Rd, Rd, Rd, Rd, Rd, Gs^Fp, Rd, Gs^Fp
Rd, Rd, Hh, Rp, Chr, Chr, Chr, Rd, Hh, Rd, Hh, Rd, Rd, Rd, Rd, Hh, Rd, Rd, Gs^Fp, Rd, Hh, Rd, Rd, Hh, Rd, Rd, Rp, Ss^Vhs, Ww, Ww, Ww, Ww, Ww, Ww, Ss, Gs^Fp, Gs^Fp, Gs^Fp, Rp, Khs, Ss, Ss, Ss, Gs^Fp, Gs^Fp, Gs^Fp, Gs^Fp, Rd, Ce, Ce, Ce, Gs^Fp
Rd, Hh, Hh, Chr, Chr, Chr, Chr, Hh, Mm, Hh, Mm, Mm, Mm, Rd, Rd, Rd, Rd, Hh, Gs^Fp, Rd, Hh, Hh, Mm, Rd, Gs^Fp, Gs^Fp, Rp, Ss^Vhs, Ss^Vhs, Ww^Bw|, Ww, Ww, Gs^Fp, Ss, Gs^Fp, Ww, Ww, Ww, Ww^Bw/, Chs, Ss, Gs^Fp, Gs^Fp, Ss, Gs^Fp, Gs^Fp, Ss, Ss, Ce, 3 Ke, Ce, Gs^Fp
Mm, Mm, Hh, Mm, Mm, Chr, 5 Khr, Mm, Mm, Mm, Mm, Mm, Hh, Gs^Fp, Gs^Fp, Rd, Gs^Fp, Rd, Rd, Rd, Mm, Mm, Mm, Hh, Hh, Gs^Fp, Cud, Rp, Rp, Cud, Ww, Gs^Fp, Hh, Gg^Efm, Gs^Fp, Gs^Fp, Ss^Vhs, Rp, Gs^Fp, Ww, Ww, Ss, Ss, Gs^Fp, Ss, Gs^Fp, Gs^Fp, Ss, Gs^Fp, Ce, Hh, Gs^Fp
Mm, Mm, Mm, Hh, Mm, Mm, Mm^Xm, Mm^Xm, Mm^Xm, Ms, Mm, Mm, Hh, Gs^Fp, Gs^Fp, Rd, Gs^Fp, Gg^Ve, Hh, Rd, Mm, Mm, Mm, Mm, Mm, Hh, Ww, Ww, Ww, Ww, Gs^Fp, Ss, Ss, Gs^Fp, Gs^Fp, Rp, Gs^Fp, Gs^Fp, Ss, Gs^Fp, Gs^Fp, Ww, Ww, Ss, Gs^Fp, Ss, Ss, Ss, Gs^Fp, Gs^Fp, Hh, Gs^Fp
Mm, Mm, Mm, Hh, Hh, Mm, Mm^Xm, Mm^Xm, Mm^Xm, Mm^Xm, Mm^Xm, Mm, Hh, Hh^Fp, Gs^Fp, Rd, Hh, Hh, Mm, Rd, Kh, Ch, Ww, Mm, Ww, Ww, Hh, Gs^Fp, Rd, Gs^Fp, Gs^Fp, Re, Gs^Fp, Ss, Ss^Bw/, Rd, Re, Ss, Ss, Ss, Ss, Ss, Gs^Fp, Ww, Ss, Gs^Fp, Ss, Gs^Fp, Gs^Fp, Hh, Gs^Fp, Gs^Fp
Mm^Xm, Mm^Xm, Mm^Xm, Mm^Xm, Hh, Mm, Ms, Mm^Xm, Mm^Xm, Mm^Xm, Mm, Mm^Vhh, Hh, Hh, Gs^Fp, Hh, Hh, Mm, Mm, Mm, Ch, Ww, Wo, Ww, Mm^Vhh, Mm, Hh^Fp, Hh^Fp, Gg^Efm, Rd, Rd, Rd, Gs^Fp, Ss^Bw|, Ss, Gs^Fp, Ss, Ss, Ss, Ss^Vm, Gs^Fp, Ss, Gs^Fp, Ww, Ww, Gs^Fp, Ss, Ss, Ss, Gs^Fp, Gs^Fp, Gs^Fp
Mm^Xm, Mm^Xm, Mm, Mm^Xm, Hh, Mm, Ms, Mm^Xm, Ms, Mm^Xm, Ha, Mm, Hh, Hh, Gs^Fp, Rd, Gs^Fp, Hh, Hh, Mm, Mm, Ww, Ww, Ww, Mm, Hh, Gs^Fp, Gg^Efm, Gs^Fp, Gg^Efm, Gs^Fp, Chs, Rd, Rp, Gs^Fp, Ss, Gs^Fp, Re, Ss, Ss, Ss, Ss, Gs^Fp, Gs^Fp, Ww, Gs^Fp, Ss, Gs^Fp, Ss, Ss, Ss, Gs^Fp
Mm^Xm, Mm^Xm, Mm^Xm, Mm^Vhh, Hh, Mm, Mm^Xm, Mm^Xm, Ai, Mm^Xm, Mm, Mm, Mm, Hh, Rp, Gs^Fp, Gs^Fp, Hh^Fp, Hh^Fp, Mm, Mm, Mm, Mm, Ww, Ww, Hh, Hh, Gs^Fp, Gs^Fp, Gg^Ve, Gs^Fp, Ss, Rp, Rp, Hh, Ss, Ss, Chs, Gs^Fp, Ss, Gs^Fp, Ss, Ss, Ss, Ss, Ww, Ww, Gs^Fp, Ss, Gs^Fp, Gs^Fp, Gs^Fp
Mm^Xm, Mm^Xm, Mm^Xm, Mm, Hh, Mm, Ms, Mm^Xm, Wo, Ai, Aa^Fpa, Mm, Mm, Hh, Gs^Fp, Gs^Fp, Gs^Fp, Re, Gs^Fp, Hh^Fp, Hh, Mm, Mm, Hh, Ww, Ww, Hh, Hh, Gs^Fp, Gs^Fp, Rp, Ss^Bw/, Ss, Gs^Fp, Ss, Gs^Fp, Ss, Re, Re, Ss, Ss, Gs^Fp, Gs^Fp, Gs^Fp, Ss, Gs^Fp, Ww, Ss, Re, Gs^Fp, Gs^Fp, Gs^Fp
Rp, Mm, Hh, Mm, Hh, Mm, Ms, Mm^Xm, Ww, Ww, Mm, Mm, Mm, Hh, Gs^Fp, Rp, Gs^Fp, Gs^Fp, Hh, Hh, Mm, Mm, Mm, Hh, Hh, Ww, Ss, Hh, Gs^Fp, Rp, Gs^Fp, Gs^Fp, Ss, Gs^Fp, Ss, Ss, Ss, Ss^Vhs, Re, Gs^Fp, Ss, Ss, Gs^Fp, Ss, Gs^Fp, Gs^Fp, Gs^Fp, Ww, Gs^Fp, Gs^Fp, Gs^Fp, Gs^Fp
Mm^Xm, Hh, Mm, Hh, Rp, Mm, Mm^Xm, Mm^Xm, Mm, Ww, Ww, Mm, Mm, Hh, Gs^Fp, Rp, Gs^Fp, Gs^Fp, Gs^Fp, Hh, Mm, Mm, Mm, Hh, Ss, Ww, Ww, Gs^Fp, Rd, Gs^Fp, Gs^Fp, Gs^Fp, Gs^Fp, Ss, Gs^Fp, Ss, Gs^Fp, Ss, Re, Hh, Gs^Fp, Gs^Fp, Gs^Fp, Gs^Fp, Gs^Fp, Gs^Fp, Gs^Fp, Ww, Ww, Gs^Fp, Gs^Fp, Gs^Fp
Mm^Xm, Mm^Xm, Mm^Xm, Mm, Mm^Xm, Hh, Hh, Mm, Ms, Mm, Mm, Ww, Ww, Hh, Hh, Gs^Fp, Gg^Ve, Rp, Gs^Fp, Hh, Hh, Mm, Mm, Hh, Gs^Fp, Gs^Fp, Ww^Bw/, Rd, Hh, Gs^Fp, Gs^Fp, Hh, Ss, Ss, Gs^Fp, Ss, Ss, Ss, Gs^Fp, Re, Re, Gs^Fp, Gs^Fp, Gs^Fp, Gs^Fp, Re, Gs^Fp, Gs^Fp, Gs^Fp, Ww, Ww, Gs^Fp
Mm^Xm, Mm^Xm, Mm^Xm, Mm, Mm^Xm, Mm, Mm, Hh, Hh, Mm, Mm, Mm, Hh, Ww, Hh, Gs^Fp, Gs^Fp, Gs^Fp, Gs^Fp, Hh^Fp, Hh, Mm, Hh, Hh, Gg^Ve, Rd, Gs^Fp, Ww, Ss, Gs^Fp, Ss, Ss, Ss, Gs^Fp, Gs^Fp, Ss, Ss, Ss, Gs^Fp, Gs^Fp, Re, Gs^Fp, Gs^Fp, Hh^Fp, Hh, Hh, Gs^Fp, Gs^Fp, Re, Gs^Fp, Gs^Fp, Ww
Mm^Xm, Mm^Xm, Mm^Xm, Mm^Xm, Ms, Mm, Mm, Mm, Hh, Mm, Mm, Ms, Hh, Ww, Gs^Fp, Gs^Fp, Gs^Fp, Gs^Fp, Rp, Gs^Fp, Gs^Fp, Hh, Hh, Gs^Fp, Rd, Rd, Gs^Fp, Ss, Ss, Gs^Fp, Gs^Fp, Ss, Ss, Ss, Ss, Ss, Gs^Fp, Gs^Fp, Gs^Fp, Gs^Fp, Gs^Fp, Re, Hh, Hh^Fp, Hh, Hh, Hh, Gs^Fp, Gs^Fp, Gs^Fp, Gs^Fp, Gs^Fp
Xu, Xu, Xu, Mm^Xm, Mm^Xm, Mm, Hh, Mm, Mm^Vhh, Hh, Hh, Hh, Gs^Fp, Ww, Ss, Ss, Ss, Gs^Fp, Rp, Rp, Chr, Hh, Chs, Chs, Chr, Gs^Fp, Ss, Ss, Gs^Fp, Ss, Ss, Ss, Chs, Ss, Ss, Gs^Fp, Gs^Fp, Gs^Fp, Re, Gs^Fp, Gg^Ve, Re, Hh, Gs^Fp, Hh, Gs^Fp, Hh, Hh, Gs^Fp, Gs^Fp, Gs^Fp, Gs^Fp
Uu, Uu, Uu, Xu, Xu, Mm, Hh, Hh, Hh, Hh, Gs^Fp, Gs^Fp, Gs^Fp, Gs^Fp, Ss, Hh, Ss, Gs^Fp, Ss, Gs^Fp, Ss, Chs, Chr, Ss, Ss, Chs, Ss, Ss, Ss, Ss, Ss, Ss, Rp, Ss, Gs^Fp, Gs^Fp, Re, Gs^Fp, Gs^Fp, Re, Gs^Fp, Hh, Hh, Hh, Hh, Hh, Hh, Hh, Gs^Fp, Gs^Fp, Gs^Fp, Gs^Fp
Xu, Xu, Xu, Cud, Uu^Ii, Hh, Hh, Hh, Gs^Fp, Gs^Fp, Gs^Fp, Gs^Fp, Re, Ss, Ss, Gs^Fp, Ss, Ss, Hh, Ss, Gs^Fp, Gs^Fp, Gs^Fp, 4 Khr, Gs^Fp, Gs^Fp, Gs^Fp, Ss, Ss, Gs^Fp, Ss, Ss, Gs^Fp, Gs^Fp, Gs^Fp, Re, Gs^Fp, Gs^Fp, Gs^Fp, Gs^Fp, Gs^Fp, Gs^Fp, Hh^Fp, Hh^Fp, Hh^Fp, Gs^Fp, Gs^Fp, Gs^Fp, Gs^Fp, Gs^Fp, Gs^Fp, Gs^Fp
Mm^Xm, Mm^Xm, Mm^Xm, Xu, Mm, Hh, Gs^Fp, Gs^Fp, Gs^Fp, Gs^Fp, Gs^Fp, Gs^Fp, Gs^Fp, Ss, Ss, Ss, Ss, Hh, Gs^Fp, Ss, Ss, Gs^Fp, Rd, Rd, Gs^Fp, Gs^Fp, Gs^Fp, Gs^Fp, Gs^Fp, Gs^Fp, Gs^Fp, Ss^Vhs, Gs^Fp, Gs^Fp, Gs^Fp, Re, Gs^Fp, Gs^Fp, Gs^Fp, Gs^Fp, Gs^Fp, Gs^Fp, Gs^Fp, Hh^Fp, Gs^Fp, Gs^Fp, Gs^Fp, Gs^Fp, Gs^Fp, Chr, Gs^Fp, Gs^Fp
Mm^Xm, Mm^Xm, Mm^Xm, Mm^Xm, Mm, Hh, Gs^Fp, Gs^Fp, Gs^Fp, Gs^Fp, Gs^Fp, Gs^Fp, Ss, Ss, Gs^Fp, Gs^Fp, Gs^Fp, Ss, Gs^Fp, Gs^Fp, Ss, Gs^Fp, Gs^Fp, Gs^Fp, Gs^Fp, Gs^Fp, Gs^Fp, Gs^Fp, Gs^Fp, Gs^Fp, Gs^Fp, Gs^Fp, Gs^Fp, Gs^Fp, Gs^Fp, Re, Gs^Fp, Gs^Fp, Gs^Fp, Gs^Fp, Gs^Fp, Gs^Fp, Gs^Fp, Gs^Fp, Gs^Fp, Gs^Fp, Gs^Fp, Gs^Fp, Gs^Fp, Gs^Fp, Gs^Fp, Gs^Fp
